101 2016001ЃЌеХШ§ 2016001ЃЌРюЫФ 2016002ЃЌЭѕЮх 2016003ЃЌСѕЮх 
102 Пе Пе Пе Пе 
103 Пе Пе Пе Пе 
104 Пе Пе Пе Пе 
105 Пе Пе Пе Пе 
106 Пе Пе Пе Пе 
107 Пе Пе Пе Пе 
108 Пе Пе Пе Пе 
109 Пе Пе Пе Пе 
110 Пе Пе Пе Пе 
201 Пе Пе Пе Пе 
202 2017001ЃЌAA 2017002ЃЌBB 2017003ЃЌCC 2017004ЃЌDD
203 Пе Пе Пе Пе 
204 Пе Пе Пе Пе 
205 Пе Пе Пе Пе 
206 Пе Пе Пе Пе 
207 Пе Пе Пе Пе 
208 Пе Пе Пе Пе 
209 Пе Пе Пе Пе 
210 Пе Пе Пе Пе 
301 Пе Пе Пе Пе 
302 Пе Пе Пе Пе 
303 Пе Пе Пе Пе 
304 Пе Пе Пе Пе 
305 Пе Пе Пе Пе 
306 Пе Пе Пе Пе 
307 Пе Пе Пе Пе 
308 Пе Пе Пе Пе 
309 Пе Пе Пе Пе 
310 Пе Пе Пе Пе 
