101 空 2016002，李四 2016003，王五 2016004，刘五 
102 空 空 空 空 
103 空 空 空 空 
104 空 空 空 空 
105 空 空 空 空 
106 空 空 空 空 
107 空 空 空 空 
108 空 空 空 空 
109 空 空 空 空 
110 空 空 空 空 
201 空 空 空 空 
202 空 空 空 空 
203 空 空 空 空 
204 空 空 空 空 
205 空 空 空 空 
206 空 空 空 空 
207 空 空 空 空 
208 空 空 空 空 
209 空 空 空 空 
210 空 空 空 空 
301 空 空 空 空 
302 空 空 空 空 
303 空 空 空 空 
304 空 空 空 空 
305 空 空 空 空 
306 空 空 空 空 
307 空 空 空 空 
308 空 空 空 空 
309 空 空 空 空 
310 空 空 空 空 
